a_ a_ a_ a_ a_ a_ a_ a_ a_ a_ a_ a_ a_ a_ a_ a_ a_ a_ a_ a_ a_ a_ a_ a_ a_ a_ a_ a_ a_ a_ a_ a_ a_ a_ a_ a_ a_ a_ a_ a_ a_ a_ a_ a_ a_ a_ a_ a_ a_ a_ a_
a_ 2_ 2_ 2_ 2_ __ __ __ __ __ __ __ __ __ __ __ __ __ __ __ __ __ __ __ __ __ __ __ __ __ __ __ 1_ 1_ 1_ 1_ 1_ 1_ 1_ 1_ 1_ 1_ 1_ 1_ 1_ 1_ 1_ 1_ 1_ 1_ b_
a_ 2_ 2_ 2_ 2_ __ __ __ __ __ __ __ __ __ __ __ __ __ __ __ __ __ __ __ __ __ __ __ __ __ __ __ 1_ 1_ 1_ 1_ 1_ 1_ 1_ 1_ 1_ 1_ 1_ 1_ 1_ 1_ 1_ 10 1_ 1_ b_
a_ 2_ 2_ 2_ 2_ __ _1 __ __ __ __ __ __ __ __ __ __ __ __ __ __ __ __ __ __ __ __ __ __ __ __ __ 1_ 1_ 1_ 1_ 1_ 1_ 1_ 1_ 1_ 1_ 1_ 1_ 1_ 1_ 1_ 1_ 1_ 1_ b_
a_ 2_ 2_ 2_ 2_ __ __ __ __ _0 __ __ _0 __ __ __ c_ __ __ __ __ __ c_ __ __ __ __ __ __ __ __ __ a_ a_ a_ a_ a_ a_ a_ a_ a_ a_ a_ a_ a_ a_ 1_ 1_ 1_ a_ a_
a_ __ __ __ __ __ __ __ __ d_ __ __ d_ __ __ __ __ __ __ __ __ __ __ __ __ __ __ __ __ __ __ __ a_ a_ a_ a_ a_ a_ a_ a_ a_ a_ a_ a_ a_ a_ 1_ 1_ 1_ a_ a_
a_ __ __ __ __ __ __ __ __ __ __ __ __ __ __ __ __ __ __ __ __ __ __ __ __ __ __ __ __ __ __ __ a_ a_ a_ a_ a_ a_ a_ a_ a_ a_ a_ a_ a_ a_ 1_ 1_ 1_ a_ a_
a_ __ __ __ __ __ __ __ __ __ __ __ __ __ __ __ __ __ __ __ __ __ __ __ __ __ __ __ __ __ __ __ a_ a_ a_ a_ a_ a_ a_ a_ a_ a_ a_ a_ a_ a_ 1_ 1_ 1_ a_ a_
a_ __ __ __ __ __ __ __ __ d_ __ __ d_ __ __ __ __ __ __ __ __ __ __ __ __ __ __ __ __ __ __ __ a_ a_ a_ a_ a_ a_ a_ a_ a_ a_ a_ a_ a_ a_ 1_ 1_ 1_ a_ a_
a_ __ __ __ __ __ __ __ __ _0 __ __ _0 __ __ __ __ __ __ __ __ __ __ __ __ __ __ __ __ __ __ __ a_ a_ a_ a_ a_ a_ a_ a_ a_ a_ a_ a_ a_ a_ 1_ 1_ 1_ a_ a_
a_ __ __ __ __ __ __ __ __ __ __ __ __ __ __ __ c_ __ __ __ __ __ c_ __ __ __ __ __ __ __ __ __ a_ a_ a_ a_ a_ a_ a_ a_ a_ a_ a_ a_ a_ a_ 1_ 1_ 1_ a_ a_
a_ __ __ __ __ __ __ __ __ __ __ __ __ __ __ __ __ __ __ __ __ __ __ __ __ __ __ __ __ __ __ __ a_ a_ 1_ 1_ 1_ 1_ 1_ 1_ 1_ 1_ 1_ 1_ 1_ 1_ 1_ 1_ 1_ 1_ a_
a_ __ __ __ __ __ __ __ __ __ __ __ __ __ __ __ __ __ __ __ __ __ __ __ __ __ __ __ __ __ __ __ a_ a_ 1_ 1_ 1_ 1_ 1_ 1_ 1_ 1_ 1_ 1_ 1_ 1_ 1_ 1_ 1_ 1_ a_
a_ __ __ __ __ __ __ __ __ __ __ __ __ __ __ __ __ __ __ __ __ __ __ __ __ __ __ __ __ __ __ __ a_ a_ 1_ 1_ 1_ 1_ 1_ 1_ 1_ 1_ 1_ 1_ 1_ 1_ 1_ 1_ 1_ 1_ a_
a_ __ __ __ __ __ __ __ __ __ __ __ __ __ __ __ __ __ __ __ __ __ __ __ __ __ __ __ __ __ __ __ a_ a_ 1_ 1_ 1_ 1_ 1_ 1_ 1_ 1_ 1_ 1_ 1_ 1_ 1_ 1_ 1_ 1_ a_
a_ __ __ __ __ __ __ __ __ __ __ __ __ __ __ __ __ __ __ __ __ __ __ __ __ __ __ __ __ __ __ __ a_ a_ 1_ 1_ 1_ 1_ 1_ 1_ 1_ 1_ 1_ 1_ 1_ 1_ 1_ 1_ 1_ 1_ a_
a_ __ __ __ __ __ _% __ __ __ __ __ __ __ __ __ __ __ __ __ __ __ __ __ __ __ __ __ __ __ __ __ a_ a_ 1_ 1_ 1_ 1_ 1_ 1_ 1_ 1_ 1_ 1_ 1_ 1_ 1_ 1_ 1_ 1_ a_
a_ __ __ __ __ __ __ __ __ __ __ __ __ __ __ __ __ __ __ __ __ __ __ __ __ __ __ __ __ __ __ __ a_ a_ 1_ 1_ 1_ 1_ 1_ 1_ 1_ 1_ 1_ 1_ 1_ 1_ 1_ 1_ 1_ 1_ a_
a_ __ __ __ __ __ __ __ __ __ __ __ __ __ __ __ __ __ __ __ __ __ __ _0 __ __ __ __ _0 __ __ __ a_ a_ 1_ 1_ 1_ 1_ 1_ 1_ 1_ 1_ 1_ 1_ 1_ 1_ 1_ 1_ 1_ 1_ a_
a_ __ __ __ __ __ __ __ __ __ __ __ __ __ __ __ __ __ __ __ __ __ __ __ __ __ __ __ __ __ __ __ a_ a_ 1_ 1_ 1_ 1_ 1_ 1_ 1_ 1_ 1_ 1_ 1_ 1_ 1_ 1_ 1_ 1_ a_
a_ __ __ __ __ __ __ __ __ __ __ __ __ __ __ __ __ __ __ __ __ __ __ __ __ __ __ __ __ __ __ __ a_ a_ 1_ 1_ a_ a_ a_ a_ a_ a_ a_ a_ a_ a_ a_ a_ a_ a_ a_
a_ a_ a_ a_ a_ a_ a_ a_ a_ a_ a_ __ __ __ __ __ a_ a_ a_ a_ a_ a_ a_ a_ a_ a_ a_ a_ a_ a_ a_ a_ a_ a_ 1_ 1_ a_ a_ a_ a_ a_ a_ a_ a_ a_ a_ _1 a_ a_ a_ a_
a_ __ __ __ __ __ __ __ __ __ __ __ __ __ __ __ __ __ __ __ __ __ __ __ b_ b_ b_ b_ b_ b_ b_ b_ b_ a_ __ __ __ __ __ __ __ __ __ __ __ __ __ _1 a_ a_ a_
a_ __ __ __ __ __ __ __ __ __ __ __ __ __ __ __ __ __ __ __ __ __ __ __ b_ __ __ __ __ __ __ __ b_ a_ __ __ __ __ __ __ __ __ __ __ __ __ __ a_ a_ a_ a_
a_ __ __ __ __ __ __ __ __ __ __ __ __ __ __ __ __ __ __ __ __ __ __ __ b_ __ __ __ __ __ __ __ b_ a_ __ __ __ __ __ __ __ __ __ __ __ __ __ a_ a_ a_ a_
a_ __ __ __ __ __ __ __ __ __ __ __ __ __ __ __ __ __ __ __ __ __ __ __ b_ __ __ _0 __ __ __ __ b_ a_ __ __ __ __ __ __ _0 __ __ __ __ __ __ a_ a_ a_ a_
a_ __ __ __ __ __ __ __ __ __ __ __ __ __ __ __ __ __ __ __ __ __ __ __ b_ __ __ __ __ __ __ __ b_ a_ __ __ __ __ __ __ __ __ __ __ __ __ __ a_ a_ a_ a_
a_ __ __ __ __ __ __ __ __ __ __ __ __ __ _2 __ __ __ __ __ __ __ __ b_ b_ __ __ __ __ __ __ __ b_ a_ __ __ __ __ __ __ __ __ __ __ __ __ __ a_ a_ a_ a_
a_ __ __ __ __ __ __ __ __ __ __ __ __ __ __ __ __ __ __ __ __ __ __ b_ b_ __ __ __ __ __ __ __ b_ a_ __ __ __ __ __ __ __ __ __ __ __ __ __ a_ a_ a_ a_
a_ __ __ __ __ __ __ __ __ __ __ __ __ __ __ __ __ __ __ __ __ __ __ __ __ __ __ __ __ __ __ __ a_ a_ __ __ __ __ __ __ __ __ __ __ __ __ __ _1 a_ a_ a_
a_ __ __ __ __ __ __ _1 __ __ __ __ __ __ __ __ __ _1 __ __ __ __ __ __ __ __ __ __ __ __ __ __ b_ a_ a_ a_ a_ a_ a_ a_ a_ __ __ __ a_ a_ 1_ a_ a_ a_ a_
a_ __ __ __ __ __ __ __ __ __ __ __ __ __ __ __ __ __ __ __ __ __ __ __ __ __ __ __ __ __ __ __ a_ __ __ __ __ __ __ __ __ __ __ __ __ __ __ __ __ __ c_
a_ __ __ __ __ __ __ __ __ __ __ __ __ __ __ __ __ __ __ __ __ __ __ __ a_ __ __ __ __ __ __ __ a_ __ __ __ __ __ __ __ __ __ __ __ __ __ __ _0 __ __ c_
a_ __ __ __ __ __ __ __ __ __ c_ c_ __ __ __ __ __ __ __ __ __ __ __ __ a_ __ __ __ __ __ __ __ a_ __ __ __ __ __ __ __ __ __ __ __ __ __ __ __ __ __ c_
a_ __ __ __ __ __ __ __ __ __ c_ c_ __ __ __ __ __ __ __ __ __ __ __ __ a_ __ __ __ __ __ __ __ a_ __ __ b_ b_ __ __ __ __ __ __ __ __ __ __ __ __ __ c_
a_ __ __ __ __ __ __ __ __ __ __ __ __ __ __ __ __ __ __ __ __ __ __ __ a_ __ __ _0 __ __ __ __ __ __ __ b_ b_ __ __ __ __ __ __ __ __ __ __ __ __ __ c_
a_ __ __ __ __ __ __ __ __ __ __ __ __ __ __ __ __ __ __ __ __ __ __ __ a_ __ __ __ __ __ __ __ __ __ __ __ __ __ __ __ __ __ __ __ __ __ __ _0 __ __ c_
a_ __ __ __ __ __ __ __ __ __ __ __ __ __ __ __ __ __ __ __ __ __ __ __ a_ __ __ __ __ __ __ __ a_ __ __ __ __ __ __ __ __ __ __ __ __ __ __ __ __ __ c_
a_ a_ a_ a_ a_ a_ a_ a_ a_ a_ a_ a_ a_ a_ a_ a_ a_ a_ a_ a_ a_ a_ a_ a_ a_ a_ a_ a_ a_ a_ a_ a_ a_ a_ a_ a_ a_ a_ a_ a_ a_ a_ a_ a_ a_ a_ a_ a_ a_ a_ a_
